एक म्यान में दो तलवारें नहीं समातीं - Two of a trade seldom agree
खरबूजे को देखकर खरबूजा रंग पकड़ता है - When the old cock crows the young cock learns
खरबूजे को देखकर खरबूजा रंग पकड़ता है - Society Moulds Man
छठी का दूध याद आना - to reduce one to complete helplessness
जब तक समुद्र रहेगा नमक तो मिलेगा ही - you never miss the water till the well runs dry
दान की बछिया के दांत नहीं देखे जाते - Don't look a gifted horse in the mouth
नाव पानी में उतार दी आगे देखा जाएगा - Here goes, sink or swim
पत्थर घिसते घिसते महादेव बन जाता है - Practice Makes A Man Perfect
बोये पेढ़ बबूल के तो आम कहाँ से होए - Gather thistles expect pricks
भैंस के आगे बीन बजाए भैंस खड़ी पगुराय - Crying in wilderness
मरे बिना स्वर्ग देखने को नहीं मिलता - A closed mouth catches no flies
मरे बिना स्वर्ग देखने को नहीं मिलता - No pains, no gains
सस्ता रोए बार बार, महँगा रोए एक बार - The cheap buyer takes the bad meat
अपनी छाछ को भला कौन खट्टा कहता है - Every man thinks his own geese swans
अषर्फियाँ लुटें और कोयलों पर मुहर - Penny wise, pound foolish
आम खाने से मतलब पेड़ गिनने से नहीं - gather in the harvest, why count the stalks
दुधारू गाय की लात भी सहनी पड़ती है - pain is forgotten when gain follows
दुविधा में दोऊ गए माया मिली न राम - he who hunts two hares leaves one and loses the other
बिना विचारे जो करे, सो पाछे पछताय - Look before you leap
होनी थी सो हो गई, सीख करे अब क्या - When a thing is done advice comes too late
ईश्वर की माया, कहीं धूप कहीं छाया - Chance of fortune is the lot of life
उलटा पलटा - At sixes and sevens
तितर बितर - At sixes and sevens
अस्त व्यस्त - At sixes and sevens
एक कान से सुनकर, दूसरे से उड़ा देना - In at one ear, and out at the other
एक तवे की रोटी क्या पतली क्या मोटी - Members of the same family enjoy equal status
घर का जोगी जोगड़ा अन्य गाँव का सिद्ध - Familiarity breeds contempt
तिलक लगाने से कोई संत नहीं हो जाता - All are not saints that go to the church
भगोड़ा सिपाही पलटन की बुराई करता है - Runaway monk never praises his convent
महंगा रोए एक बार सस्ता रोए बार बार - The cheap buyer takes the bad meat
वक्त पर एक टॉँका नौ का काम देता है - a stitch in time saves nine
श्री गणेष अच्छा हो तो काम हुआ समझो - well began is half done
अपने आपको लाट साहब का साला मानना - to have a swollen head
दान दिए ते न घटे धन, करती और लोभ - Alms giving never made any man poor
दो का साथ, तीसरा आँखों में ठीकरा - Two is company, three is crowd
पाक दामन होना सबसे बड़ा हथियार है - clear consience is a sure card
मित्र वही जो विपित्त में काम आये - A friend in need is a friend indeed
मीठी मीठी बातों से पेट नहीं भरता - Bare words buy no barley
अँधेरी रात, चार दिन की चाँदनी फिर - Prettiness dies quickly
गले पडी की खंझड़ी बजाने में ही खैर - You must play on the drum hung from your neck
थोड़ा करके बड़े बड़े काम हो जाते हैं - Little strokes fell mighty oaks
धन देता है तो छप्पर फाड़कर देता है - When God wills all winds bring rain
बाप बड़ा न भैया सबसे बड़ा रुपैया - Money rules over relationships as well
महाभारत की पूरी तैयारी कर ली जाना - To be all set for action
अपने आपको अफलातून का नाती समझना - to grow too big for one's boots
अपने दही को कोई खट्टा नहीं कहता - Every man thinks his own geese swans
दिन दूनी रात चौगुनी उन्नति करना - to grow by leaps and bounds
दूध को दूध और पानी को पानी कहना - to call a spade a spade
पैसा तो प्यारा है पर चाम ज्यादा - the shirt is nearer then the coat
बिल्ली के सिरहाने दूध नहीं जमता - A watched pot never boils
बोया पेड़ बबूल का आम कहाँ से खाय - Gather thistles expect pricks
मुफ्त के बैल के दाँत क्या देखना - Never look a gift horse in the mouth
ईष्वर की माया कहीं धूप कहीं छाया - Chance of fortune iss the lot of life
उतने पाँव पसारिए, जितनी चादर होय - Be satisfied which what is available
एक फूल के खिलने से बहार नहीं आती - one swallon does not make a summer
औरन का गड्ढा चाहे ताको कूप तैयार - he who digs a pit for others himself falls into it
चढे तवे पर रोटी सभी डाल लेते हैं - If a man ever falls all will bread on him
चार दिन की चांदनी फिर अंधेरी रात - A nine days wonder
दरिया में रहना और मगरमच्छ से बैर - You cannot live in Rome and fight with the Pope
पते की बात कहना (गुत्थी सुलझाना) - to make a remarkable utterance
पाँचों उँगलियाँ बराबर नहीं होतीं - There are men and men
बड़े आदमी ही बड़ेू काम कर सकते हैं - only an elephant can bear an elephant's load
भाब्दों से आदमी की पहचान होती है - Fool is recognized by a spoken word
मजे के लिए चाचा सलाह के लिए बाबा - If you wish for advice consult an old man
माया को माया मिले कर कर लंबे हाथ - Money Begets Money.
रसरी आवत जात तै सिल पै परत निषान - Practice makes a man perfect.
सब्र का फल मीठा होता है - Slow and steady wins the race.
संकल्प सफलता की कुजी है - Strong will is the key to success.
लातों के भूत बातों से नहीं मानते - Honey is not made for the ass's mouth
विद्वान का बेटा मूर्ख हो सकता है - Good cow may have an ill cow.
विपत पड़े जो कर गहे, सोई साँचो मत - A friend in need is a friend indeed.
अपना अपना पराया पराया - Blood is thicker than water
सबसे बड़ा नंग नंग से बड़ा परमेष्वर - Beware of him who regards not his own reputation.
साँप निकल जाने के बाद लकीर पीटना - To kiss the hare's foot.
अपने दोष न देखे, दूसरे के गिने - Do not see your faults, count the other.
अपने पाँव पर आप कुल्हाड़ी मारना - To harm oneself by acting foolishly
अषरफियाँ लुटें, कोयलों पर मोहर - Penny wise, pound foolish
अपना नीगर पराया टींगर - The crow thinks her own birds fairest.
अपनी तकदीर आप बनती है - Every man is the architect of his own destiny.
मुफ्त की भाराब काजी को भी हलाल - An open door will tempt even a saint
मूँछों पर ताव देना - To express loftiness.
होनहार बिरवान के होत चीकने पात - Coming events cast their shadows before
अंधे अंधा ठेलिया दोनों कूप पड़ंत - When the blind lead the blind both shall fall into the ditch
अंधे को खिलाना फिर घर छोड़कर आना - Dance and pay the piper too
आवाँ का आँवाँ ही खराब - Having a disgusting lot.
दाल में कुछ काला होना - To suspect foul play.
घर में नहीं दाले भादी चले रचाने - Love in a cottage
घूरे के दिन फिरना, बारह बरस बाद - No man is always unlucky.
छाज बोले सो बोले छलनी क्या बोले - Pot calling the kettle black.
जल में रहकर मगर से बैर ठीक नहीं - You cannot live in Rome and fight with the Pope.
झूठे दोस्त से खुला दुष्मन अच्छा - Better an open enemy than a false friend
ठनठन गोपाल - Out of pocket.
दीवार ढह जाना - Barriers to be razed.
दो पाटों के बीच पिसना - To be pounded between mortar and pestle.
पक्के विरोधी दोस्त नहीं हो सकते - Parallel lines never meet
बाप ने मारी मेंढकी बेटा तीरंदाज - Many talk of robinhood who never shot with his bow.
राजा भोज की पोषाक में गंगू तेली - Hog in armour.
वह लड्डू जो मिला नहीं सबसे मीठा - Forbidden fruit is sweet
सबसे भली चुप, सबसे भला चुप रहना - Silence is golden
दाँतों तले उँगली दबाना - To be stricken as with grief
समाई के बाद मष्क भी फूट जाती है - It is the last straw that breaks the camel's back
एक जुर्म करे दूसरा भोगे - Ian commits the fault and may bears the blame.
एक तीर से दो शिकार करना - Kill two birds with one stone.
आसमान का थूका मुँह पर पड़ता है - He who blows in the dust fills his own eyes
अपने दही को हर कोई सराहता है - Every potter praises his own pot
पानी में रहकर मगर से बैर करना - To live in rome and fight with pope.
काले कंबल पर रंग चढ़ाना - To attempt the impossible
काले कंबल पर रंग चढ़ाना - To waste one's time or efforts.
बिना रोए माँ भी दूध नहीं देती - A closed mouth catches no flies.
खाली दिमाग शैतान का घर - An empty mind is the devil's workshop.
खोदा पहाड़, निकली चुहिया - A most disappointing result.
गधे से घोड़े का काम लेना - Make a silk purse out of a sow's ear.
जंगल की आग की तरह फैलना - To spread like wild fire.
जब जग नाचे नाच पेट पीठ के करने - Back and the belly keep everyone busy
ठंडा लोहा गरम लोहे को काटता है - A soft answer cools wrath
तेते पाँव पसारिए जेती लंबी सौर - To live within one's means.
जबान कैंची की तरह चलाना - To have a long tongue
जबान कैंची की तरह चलाना - To talk garrulously.
तेली का काम तमोली से नहीं होता - Every cobbler should stick to his last.
न नौ मन तेल होगा न राधा नाचेगी - If the sky falls we shall catch larks.
तेल देखो तल की धार देखो - See which way the cat jumps
भाक्ल चुड़ैल की मिजाज परियों का - Fine feathers make fine birds
धन सबको अंधा कर देता है - Gold is the dust that blinds all eyes.
मतलबी यार किसके दम लगाया खिसके - Dinner over, away go the guests.	.
न बासी बचे न कुत्ता खाए - To live from hand to mouth.
आँखों पर पट्टी बाँधना - To be blind to a reality.
पहले आत्मा फिर परमात्मा - Self before service
हड़ लगे न फिटकरी, रंग चौखा होना - To achieve the desirable rusult without much effort and expense.
हमारी बिल्ली और हमीं से म्याऊँ - Frankstein's monster.
समरथ को नहिं दोष गुसाईं - King does no wrong
समरथ को नहिं दोष गुसाईं - Rich men have no faults.
अच्छों से भी गलती हो जाती है - The best cart may overthrow.
साँप के सँपोले ही होंगे - As the crow is, so the egg shall be.
हथेली पर जान लेकर घूमना - Bold as a blind bayard
अपने काम से काम रखना - To mind one's own business.
आसमान पर होना - To be too big for one's boots.
आवष्यकता आविश्कार की जननी है - Necessity is the mother of invention.
आग लगने पर कुआँ खोदना - To shut the stable door after the horse is stolen
दाँतों में तिनका लेना - To show submissiveness in the face of displeasure.
अंधे के आगे रोए, अपने नैन खोए - Casting pearls before a swine.
हँसी उड़ाना - To make fun of.
इष्क और मुष्क छिपे नहीं छिपते - Love and cough cannot be hidden
आस्तीन में साँप पालना - To cherish a serpent in the bosom.
खाली हाथ आए हो खाली हाथ जाओगे - Shrouds have no pockets
आसमान सिर पर उठा लेना - To raise hullabaloo
आसमान सिर पर उठा लेना - To create havoc
आसमान सिर पर उठा लेना - To create a ballyhoo.
म्याऊँ की ठौर कौन पकड़ेगा - One taking the danger for a common cause.
इधर की दुनिया उधर हो जाना - To have an impossibility materialised.
औरत का गुस्सा खुदा का कहर - Hell hath no fury like a woman scorned.
एक ही थैली के चट्टे बट्टे - Tarred with the same brush.
गले मे माला, दिल में काला - Beads along the neck and the devil in the heart.
भाक्ल से मोमन, करतूत से काफिर - Wolf in lamb's clothing.
भुस में आग लगाय जमालो दूर खड़ी - To be casual after causing a crisism.
राजा पर भी नियम लागू होते हैं - Caesar is not above the grammarians.
अपनी लगाई आग में आप जल जाना - Hoist with one's own petard.
आसमान जमीन के कुलाबे मिलाना - To boast wildly.
आसमान से गिरा खजूर में अटका - Between the devil and the deep sea.
अब पछताए होत क्या जब चिड़िया चुग गई खेत - It is no use crying over spilt milk.
बहती गंगा में हाथ धोना - Make hay while the sun shines.
गले पड़ा ढोल बजाना पड़ता है - What can not be cured must be endured.
खिसियानी बिल्ली खंभा नोचे - A thrashed army resorts to rampage.
पाँव जले की धरती खिसकना - To have cold feet
आँख का अंधा गाँठ का पूरा - A nitwit with a fat purse.
बात लाख की, करनी खाक की - A long tongue has a short hand.
मक्खी के स्थान पर मक्खी - To be foolishly letter bound.
मधुर वचन सौ क्रोध नसाही - A soft answer turns away wrath.
एक लकड़ी से सबको हाँकन - To tar everybody with the same brush.
जिसकी लाठी उसकी भैंस - Might is right.
वीरता का काम न चाहे नाम - Good deeds need no show.
आम के आम गुठलियों के दाम - Earth's joys and heaven's blessings combined
दोनों हाथ में लड्डू होना - To have the best of both the worlds.
आग लगाकर पानी को दौड़ना - To make a show of remedying a dire situation created by oneself
तोते की तरह आँखें फेर लेना - To refuse to recognize
आरसी क्या, हाथ कंगन को - A self evident fact requires no proof.
आषा बड़ी मायावी होती है - He who lives in hope dances to an ill tune.
डाइन भी सात घर छोड़ देती है - A wise fox will never rob his neibhour's hen roost.
दरिया को कूजे में बंद करना - To be concise in speech.
दिन को तारे दिखाई देना - To be beaten severely to live a gloomy or wretched life.
दिल की दिल में रह जाना - One's longing to remain unfulfilled.
ढाई ईंट की अपनी अलग मस्जिद - To plough a lonely furrow
ढाई ईंट की अपनी अलग मस्जिद - To blow one's trumpet.
तवा हाँडी को काला बताता है - The sooty oven mocks the black chimney
दूधों नहाना पूतों फलना - To flourish in wealth and progeny
अट्ट भी मेरी पट्ट भी मेरी - Heads 1 win and tails you lose.
पाँव में मेंहँदी लगाना - Not to move anywhere.
पूत आपनो सब कहँ प्यारी - Every potter praises his own pot.
दिमाग का पुरजा ढीला होना - To have a screw loose.
बिना चावल के खीर पकाना - To make bricks without straw.
बिसात से बाहर काम करना - To bite off more than one can chew.
दीवार के भी कान होते हैं - Hedges have eyes
दीवार के भी कान होते हैं - Even walls have ears.
मियान में से निकल पड़ना - To be sudden and quick in quarrel
दूध देना पर मेंगनी डालकर - Grace lies not in giving the gift but in the manner in which it is given
अपने पैरों पर खड़ा होना - Paddle own canoe.
आपित्तकाले मर्यादानास्ति - Necessity knows no law.
आँखों के बल - Carefully
दिन दूनी रात चौगुनी - To grow by leaps and bounds.
इज्जत मिट्टी में मिलाना - Honour comes to dust.
एक फूल से माला नहीं बनती - One flower makes no garland.
एक हाथ से ताली नहीं बजती - It takes two to make a quarrel.
उलटा चोर कोतवाल को डाँटे - The case of a thief threatening the policeman.
ओस चाटे प्यास नहीं बुझती - The dew can never slake one's thirst
हर सीपी से मोती नहीं मिलता - You cannot make a mercury of every log
कंगाल का कोई क्या लूटेगा - The beggar may sing before the thief.
एक एक कौड़ी दाँत से पकड़ना - To be stingy to a penny.
चित भी मेरी, पट भी मेरी - Heads i win and tails you lose.
बड़े लोग छोटा काम नहीं करते - An eagle does not hawk at flies.
भिड़ के छत्ते में हाथ डालना - To stir up dire trouble for oneself
तकदीर का लिखा मिटता नहीं - What is allotted cannot be blotted.
तबेले की बला बंदर के सिर - The fault of the horse is put on the saddle.
तीन का टट्टू तेरह का जीन - A penny plain and two pence coloured.
अल्लाह को प्यारा हो जाना - To kick the bucket.
आसमान में थिगली लगाना - To be too crafty.
मधुर बानी दगाबाज की निषानी - To much courtesy, too much craft.
जले पर नमक छिड़कना - To add insult to injury.
नया नौ दिन पुराना सौ दिन - The new fades and the old endures
दुशाले में लपेटकर मारना - To soften the impact of an attack
रोते हुए गए मरे की खबर लाए - Faint heart never won fair lady
एक तो करेला दूजे नीम चढ़ा - A pimple has grown upon an ulcer.
फजूलखर्ची पर कमर बंधी है - To burn the candles at both ends.
बंदर की बला तबेले के सिर - Transference of the affiction to another head.
बड़े लाभ के लिए थोड़ी हानि - Venture a small fish to catch a great one.
दहषत पैदा करना, दिल में - To strike terror into the hearts.
बुद्धिमान को इषारा काफी - A word to the wise.
हिसाब चुकाना - To settle an account.
हाथ में मेहँदी लगी होना - To be incapable of taking necessary action.
बाघ से लड़ने के लिए बघनखा - He must have iron nails that scratches a bear.
दुर्बलता में क्रोध अधिक - A little pot is soon hot.
भोर की माँद में पैर रखना - To verture a dangerous undertaking
छुद्र नदी भरि चलि उतराई - Little things are great to little men.
हाथ में माला दिल में काला - Cross on the breast and the devil in the heart.
समझ के खर्चे समझ के बोले - Keep your purse and your mouth close.
साँप के बिल में हाथ डालना - To invite danger.
हथेली पर सरसों नहीं जमती - Rome was not built in a day.
टूट गई मंगली रह गया ब्याह - Many a slip between the cup and the lip.
दवाजे की मिट्टी खोद डालना - To visit someone too frequently.
साँप का काटा रस्सी से डरे - A burnt child dreads the fire.
धन की अपेक्षा सुनाम अच्छा - Good name is better than riches.
नकेल किसी के हाथ में होना - To be in leading strings.
नाक पर मक्खी न बैठने देना - To allow none to acquire an upper hand
बगल में छुरी मुँह में राम - Wolf in lamb's skin
बगल में छुरी मुँह में राम - Wolf in sheep's clothing.
एक चने से भाड़ नहीं फूटता - Alone soldier cannot win a battle
मन चंगा तो कठौती में गंग - To the pure, everything is pure.
मनुश्य की पहचान उसकी संगत - A man is known by the company he keeps.
लंबा पर सही रास्ता ही ठीक - Farthest way about is the nearest way home.
गिरगिट की तरह रंग बदलना - To turn cat in pan.
रात है तो प्रभात दूर नहीं - Every cloud has a silver lining.
अंधों में काना राजा - A Figure among cyphers.
अंत भला सो भला - All is well that ends well
आप सुखी तो जग सुखी - He that is warm thinks all are so
आम से टपका बगल में अटका - Out of the frying pan into the fire
अपने मुहं मियां मिट्ठू मत बनो - Self praise is no recommendation
आगे दौड़ पीछे चौड - Haste makes waste
आँख ओझल पहाड़ ओझल - Out of sight
आवश्यकता अविष्कार की जननी है - Necessity is the mother of invention
अन्धा क्या जाने बसंत की बहार - A blindman is no judge of colours
अपना अपना, पराया पराया - Blood is thicker than water
अच्छा वही जो अच्छा कार्य करे - Handsome is that handsome does
इलाज से परहेज अच्छा - Prevention is batter than cure
ऊंट के मुहं में जीरा - A drop of the ocean.
उपदेश देने से स्वयं उपदेशों पर चलना बेहतर है - Example is better than precept.
एक हाथ से ताली नहीं बजती - It takes two make a quarrel
एक पंथ दो काज - Two kill two birds with one stone
एकता में बल - Union is strenght
एक चुप सौ सुख - Silence is the best
एक गंदी मछली सारे तालाब को गंदा कर देती है - A single sheep infects the whole flock
ऊँची दुकान फीका पकवान - Much cry, little wool
कर भला हो भला - Godness never goes unrewarded
कोठी वाला रोये, छप्पर वाला सोये - Uneasy lies the head that wears the crown
कुत्ते का कुत्ता बैरी - Two of a trade seldom agree.
कद्र खोद देता है रोज का आना जाना - Familiarity breeds contempt
करत करत अभ्यास से जड्मुती होत सुजान - practice makes a man perfect
खाली बैठे सैतानी सूझे - An idle man’s brain is a devil’s workshop
खोदा पहाड़ निकली चुहिया - Much ado about nothing
कानी के ब्याह में नौ सौ जोखिम - There is many a slip between the cup and the lip
गले पड़ा ढ़ोल बजाना ही पड़ता है - What cannot be cured. nust be endured
घर घोडा नकास मोल - To build castles in the air
घर वाला घर नहीं हमें किसी का दर नहीं - When the cat is away, the mice will play
चार दिन की चांदनी फिर अँधेरी रात - A nine day’s wonder
चोर चोर मौसेरे भाई - Birds of a feather flock together
चलती का नाम गाढ़ी - Nothing succeeds like success
चोरी का गुड मीठा होता है - Forbidden fruit is sweet.
जैसा करोगे वैसा भरोगे - As you sow, so shall you reap.
जो गरजते हैं वो बरसते नहीं - Barking dog seldom bite
जैसा आया वैसा गया - Evil gotten, evil spent.
जिसकी लाठी उसकी भैंस - Might is right
जाके पांव न फटी बुवाई सो क्या जाने पीर पराई - No one knows the weight of another’s burben
जैसे तो तैसा - Tit for tat
जब तक सांस तब तक आस - Hope sustains life.
जितना गुड डालोगे उतना ही मीठा होगा - The deeper the well, the sweeter the water
जहाँ फूल वहां काँटा - Where there is a flower, there is a thorn
जितने मुहं उतनी ही बात - So many man, so many minds
झूठ के पांव नही होते - A liar has no legs to stand upon.
डूबते को तिनके का सहारा - A drowning man catches at a straw
डरे सो मरे - Cowards die so many times before their death
तेते पावं पसारिये जेती लम्बी सौर - Cut you coat according to your cloth
तुम तो ईद के चाँद हो गये - Your visits are few and far between
तुम एक ही थैली के चट्टे बट्टे हो - You are chips of the same block
तंदरुस्ती हजार नियामत - Good health is above wealth
थोथा चना बाजे घना - An empty vessel sounds high.
दूध का जला छाछ को भी फूंक कर पीता है - A burnt child dreads the fire
दरिद्रता कहल की जड़ है - Poverty breeds stife
तेल देखो तेल की धार देखो - Let us see which way the wind blows
दाम बनाये काम - Mone makes the mare go.
दूर के ढ़ोल सुहावने - Distance lands charm the viewer.
डाल में कुछ काला है - There is something wrong at the bottom
धन से धन कमाया जाता है - Money begets money.
धोबी का कुत्ता घर का न घाट का - A rolling stone gathers no mass
नाच न जाने अगन टेढ़ा - A bad workman quarrels with his tools
नौ नकद न तेरह उधार - A bird in hand is batter than two in the bush
नीम हकीम खतरे जान - A little knowledge is a dangerous thing
नेकी कर दलिया में डाल - Do good and cast it into the river
निर्धनता में मित्रों की पहचान होती है - Adversity tries friends
नदी में रहना और मगरमच्छ से बैर - It is hard to live in Rome and fight with the pope.
निर्धन की पत्नी सबकी भाबी - A light purse is a heavy curse.
निराशा में भी आसा की झलक होती है - Every dark clouds has a silver lining.
पाप का धन प्रायश्चित में जाता है - Ill got, ill spent
पहले तोलो फिर बोलो - Think before you speak
परमात्मा देता है तो छप्पर फाड़ के देता है - When God wills all winds bring rain
परमात्मा गंजे को नाख़ून न दे - Curst cows have short horns
पहले अपना फिर पराया - Charity begins at home
बद अच्छा बदनाम बुरा - A bas man is batter than a bad name
बीती सो बीती - Let bygones by bygones.
बहती गंगा में हाथ धोना - Make the best of every chance
बूंद बूंद करके घड़ा भरता है - Many a little makes a mickle
बिना सेवा मेवा नहीं - No pains, no gains
बन्दर क्या जाने अदरक का स्वाद - To cast pearls before swine
बहुत से जोगी मठ उजाड़ - Too many cooks spoil the broth
बुरी संगत से अकेला भला - Better alone than in a bad company
बेकार से बेगार भली - It is batter to wear out than to rust out
बुद्धिमान को संकेत और मुर्ख के लिए फटकार - A nod to the wise and a rod to the foolish
बनी के सभी मित्र बिगड़ी का कोई नहीं - When the purse is full friends are plenty
बीता हुआ समय कभी हाथ नहीं आता - Time once passed
बीता हुआ समय कभी हाथ नहीं आता - gone can never be recalled
बिना रोये माँ भी दूध नहीं देती - A ckosed mouth catches no fly
बुराई को आरंभ में ही दबा दो - Nip the evil in the bud
भैंस के आगे बीन बजाना - Crying in wilderness
भागते चोर की लंगोटी ही सही - Something is better than nothing
भगवान की माया , कहीं धूप कहीं छाया - Chance of fortune iss the lot of life
मुख में राम ,बगल में छुरी - A wolf in lamb’s clothing
मेरे मन में कुछ और है ,करता कें कुछ और - Man process, God disposes
मुसीबत कभी अकेले नहीं आती - Misfortunes never come alone
म्रत्यु का कोई समय नहीं - Death keeps no calender.
मेहमान एक या दो दिन का होता है - A constant guest is never welcome
मनुष्य अपनी संगति से पहचाना जाता है - Man is known by the company he keeps
मुफ्त की शराब काजी को भी हलाल - An open door tempts even a saint
मनुष्य गलती का पुतला है और भगवान का काम माफ़ करना है - To err is human; to forgive divine.
राई का पर्वत बनाना - To make mountain of the mole hill
रस्सी जल गई पर बल न गया - Wolves may lose their teeth but not their nature
लोहे को लोहा काटता है - Diamond cuts diamond
लक्ष्मी चंचला होती है - Riches have wings
लोगों की वाणी , इश्वर की वाणी - Voice of the people is the voice of God
लातों के भूत बातों से नहीं मानते - Rod is the logic of fools
सच्ची बात चुभती है - Truth is always bitter
सुबह का भुला यदि शाम को घर लोट आए तो उसे भूला नहीं कहते - It is very too late to mend.
सहज पके सो मीठा होए - Slow and steady wins the race
सुन्दरता को आभूषण की आवस्यकता नहीं - Beauty need no brnaments
सांच को आंच नहीं - Truth fears no test
सावन के अंधे को हरा ही हरा दिखाई देता है - Everything looks pale to the jaundiced eye.
समय सब घावों का मरहम है - Time is a great healer
होनहार बिरवान के होत चिकने पात - Coming events cast their shadows before.
हत्या के बदले फासीं - Measure for measure.
हथेली पर दही नहीं जमती - Rome was not built in a day
हवाई किले बनाना - To build casties in the air
हाथी के दांत खाने के और दिखाने के और - All that glitters is not gold
अब पछताए होत क्या जब चिडिया चुग गयी खेत - It’s no use to cry over spilt milk
अपनी गली में कुत्ता भी शेर होता है - Every cock fights best on its own dunghill.
आप मरे जग प्रलय - Death’s day is droom’s day
आँख ओझल - Out of sight
आज का कार्य कल पर मत छोडो - Do not put off till tomorrow
कुसंगत से अकेला भला - Better alone than in bad company
उल्टे बांस बरेली को - To carry coal to new castle
दुसरे के फटे में पांव नहीं देते - Sweep before your own door.
जहाँ चाहा वहां राह - Where there is well, there is a way
दिये तले अँधेरा - Nearver the church farther from God.
चोर की दाढ़ी में तिनका - A guilty conscience needs no accuser
बूँद बूँद करके तालाब भरता है - Little drops make the ocean
ईस्वर उसकी सहायता करता है जो अपनी सहायता स्वेम करते हैं - God helps those who help themeselve
घर्णा से घ्रणा पैदा होती है - Love begets love and hate begets hate
मित्र वही है जो मुसीबत मैं काम आता है - A friends in need is a friend indeed
बिना खतरे लाभ नहीं - Nothing venture, nothing have
इमानदारी अच्छी नीति है - Honesty is the best policy
शक्कर खोर को परमात्मा शक्कर देता है - Spend and God will send
नाम बड़ा या दाम - A good name is batter than riches
न नौ मन तेल होगा न राधा नाचेगी - If the sky falls, we shall catch larks
कोयले की दलाली में मुहं काला - Evil pursuits bring bad reputation
समय सब घावों का इलाज है - Time blunts the edge of grief
दोस्तों के साथ नरक भी स्वर्ग है - Death with friends is a festival
घर को जोगी जोगडा बहार का जोगी सिद्ध - A prophet is seldom honoured in his own land
सौ दिन चोर के एक दिन साध का - Evil can bot prosper for ever
घमंडी का मुहं काला - Pride goeth before a fal
अपने घर जैसा सुख कहीं भी नहीं - east or west, home is the best
जोड़ जोड़ मर जाएँगे माल जमाई खायेगा - He who hoards takes pains for others
वही तुम वही तुम्हारा राग - Harping on the same string
नेकी करने के बाद याद आती है - Virtue survives the grave
दीवार के भी कान होते हैं - Even walls have ears
अभी दिल्ली दूर है - It is a far cry
हाथ न पहुंचे थूकौडी - Grapes are sour
दुसरे के साथ वैसा ही व्यवहार करो जैसा तुम चाहते हो की वो तुमसे करें - Do unto others as you wish to be done by them
अक्ल बड़ी के भैंस - Wisdom is better than strengh
व्यवसाय में लज्जा कैसी - Business is business
हर उन्नति के उपरांत अवनति - Every tide has its ebb, he who rises, must fall
घर का भेदी लंका ढाए - A traitor is the worest enemy
गेहूं के साथ घुन भी पिस जाता है - When the two bulls fight, it is the grass that suffers
भिडों के छते को मत छेड़ो - Let the sleeping dogs lie
लालच बुरी बात है - Greed is a curse.
तलवार से कलम बड़ी है - Pen is mightier than the sword
जो बचाया सो कमाया - Money saved, is money earned
विद्या सबसे बड़ा धन है - Knowledge is power
कुत्ते को घी हजम नहीं होता - An upstart always grows haughty
सवाल गंदम जबाब चना - A talk of chalk and you talk of cheese
लकीर का फकीर - A leopard can not change it’s spots
भेड़ चाल - Mob Mentality
जैसी करनी, वैसी भरनी - As You Sow, So Shall You Reap
जंगल में मोती की कदर नहीं होती - A thing is valued where it belongs
आप भला तो जग भला - To The Good The World Appears Good
थोथा चना बाजे घना - An Empty Vessel Makes Much Noise
तंदरुस्ती हजार नियामत है - Helath Is Wealth
गया वक्त फिर हाथ नहीं आता - Time Once Lost Cannot Be Regained
एक और एक ग्यारह होते हैं - Union Is Strenght
गधे को गधा खुजलाता है - Fools Praise Fools
अपनी अपनी डफली, अपना अपना राग - Many Heads Many Minds
जो गरजते हैं सो बरसते नहीं - Barking Dogs Seldom Bite
मन के लड्डुओं से भूक नहीं मिटती - It Is No Use Building Castles In The Air
उधार दीजे, दुश्मन कीजे - Give Loan, Enemy Own
एक थैली के चट्टे बट्टे - Birds Of a Feather Flock Together
जहाँ चाह वहां राह - Where There is a Will, There Is a Way
नाच न जाने आँगन टेढा - A Bad Carpenter Quarrels With Hi tool
चुप माने, आधी मर्जी - Silence Is Half Consent
आदमी पेट का दास - A Man Is a Slave to His Stomach
मुहं में राम, बगल में छुरी - A Honey tongue, a Heart Of Gall
झूठ का अंत नहीं - One Lie leads to Another
संसार में हर तरह के लोग होते हैं - It Takes All Sorts To Make The World
हर चमकने वाली चीज सोना नहीं होती - All that glitters is not gold.
जल में रहकर मगर से बैर - You cannot live in Rome and fight with the Pope.
उल्टा चोर कोतवाल को डांटे - The pot is calling the kettle black.
जैसा बोओगे वैसा काटोगे - As you sow, so shall you reap.
आसमान से गिरा खजूर में अटका - Between the devil and the deep sea.
नाम लिया और शैतान हाजिर - Think of the devil and the devil is here.
दुम दिखाकर भाग जाना - To show a clear pairs of heels.
जैसा देश वैसा भेष - When in Rome, do as Romans do.
अब पछताए होत क्या जब चिड़िया चुग गई खेत - There is no use of crying over spilt milk.
घर का भेदी लंका ढाहे - A black sheep.
बंदर क्या जाने अदरक का स्वाद - Laying pearls before swine.
घर की मुर्गी दाल बराबर - familiarity breeds contempt
जितनी चादर उतने ही पैर पसारो - Be satisfied which what is available
सौ सुनार की, एक लोहार की - Hundred times more furious counter blast
जान है तो जहान है - If you have life, you have the world
जंगल में मोर नाचा किस ने देखा? - Wood In A Wilderness?
नौ सौ चूहे खाके बिल्ली हज को चली - After eating 900 mice, the cat move on to a pilgrimage.
हाध कंगन को आरसी क्या - Evidence doesn’t require proof.
जब लक्ष्मी तिलक करती हो, तब मुंह धोने नहीं जाना चाहिए - Never turn down an opportunity for wealth gains
शक का इलाज तो हकीम लुक़्मान के पास भी नहीं था - There is no cure for doubt
लातों के भूत बातों से नहीं मानते - Persusion will not persuade fools
आप हारे और बहू कॊ मारे - To blame others for your failures
आ बैल मुझे मार - To ask for trouble
इस हाथ दे उस हाथ ले - Early sow , early mow
ना उधॊ कॊ देना ना माधॊ से लेना - neither a borrower, nor a lender
किये धरे पे गू का लीपा - flush gold down the toilet
जिनके घर शीशे के होते हैं, वे दूसरों पर पत्थर नहीं फ़ेंका करते - Those who live in glass houses shouldn’t throw stones at others
आमदनी अठन्नी और खर्चा रुपैया - When expenditures exceed income
काला अक्षर भैंस बराबर - Illiterate
पुरानी आदत मुशकिल से मरती है - Old habits die hard
अंधेरे में तीर चलाना - Dance in the dark
अपनी अपनी ढपली अपना अपना राग - Their Dpli their own passion
अँधेरे घर का उजाला - Darkness, the light of the house
ओखली में सिर दिया तो मूसली से क्या डर - Pestle in a mortar, then head of the fear
ऊँची दुकान फीका पकवान - More of the show but less in quality
अंधों की दुनिया में आईना बेचना - sell mirrors in the world of blind people
आँख का अन्धा नाम नैनसुख - Name nainsook blind eye